type octile
height 50
width 55
map
.......................................................
.......................................................
...@@@@@@@@@@@@@@@..@@@@@@@@@@@@@@@..@@@@@@@@@@@@@@@...
...@@@@@@@@@@@@@@@..@@@@@@@@@@@@@@@..@@@@@@@@@@@@@@@...
.......................................................
.......................................................
...@@@@@@@@@@@@@@@..@@@@@@@@@@@@@@@..@@@@@@@@@@@@@@@...
...@@@@@@@@@@@@@@@..@@@@@@@@@@@@@@@..@@@@@@@@@@@@@@@...
.......................................................
.......................................................
...@@@@@@@@@@@@@@@..@@@@@@@@@@@@@@@..@@@@@@@@@@@@@@@...
...@@@@@@@@@@@@@@@..@@@@@@@@@@@@@@@..@@@@@@@@@@@@@@@...
.......................................................
.......................................................
...@@@@@@@@@@@@@@@..@@@@@@@@@@@@@@@..@@@@@@@@@@@@@@@...
...@@@@@@@@@@@@@@@..@@@@@@@@@@@@@@@..@@@@@@@@@@@@@@@...
.......................................................
.......................................................
...@@@@@@@@@@@@@@@..@@@@@@@@@@@@@@@..@@@@@@@@@@@@@@@...
...@@@@@@@@@@@@@@@..@@@@@@@@@@@@@@@..@@@@@@@@@@@@@@@...
.......................................................
.......................................................
...@@@@@@@@@@@@@@@..@@@@@@@@@@@@@@@..@@@@@@@@@@@@@@@...
...@@@@@@@@@@@@@@@..@@@@@@@@@@@@@@@..@@@@@@@@@@@@@@@...
.......................................................
.......................................................
...@@@@@@@@@@@@@@@..@@@@@@@@@@@@@@@..@@@@@@@@@@@@@@@...
...@@@@@@@@@@@@@@@..@@@@@@@@@@@@@@@..@@@@@@@@@@@@@@@...
.......................................................
.......................................................
...@@@@@@@@@@@@@@@..@@@@@@@@@@@@@@@..@@@@@@@@@@@@@@@...
...@@@@@@@@@@@@@@@..@@@@@@@@@@@@@@@..@@@@@@@@@@@@@@@...
.......................................................
.......................................................
...@@@@@@@@@@@@@@@..@@@@@@@@@@@@@@@..@@@@@@@@@@@@@@@...
...@@@@@@@@@@@@@@@..@@@@@@@@@@@@@@@..@@@@@@@@@@@@@@@...
.......................................................
.......................................................
...@@@@@@@@@@@@@@@..@@@@@@@@@@@@@@@..@@@@@@@@@@@@@@@...
...@@@@@@@@@@@@@@@..@@@@@@@@@@@@@@@..@@@@@@@@@@@@@@@...
.......................................................
.......................................................
...@@@@@@@@@@@@@@@..@@@@@@@@@@@@@@@..@@@@@@@@@@@@@@@...
...@@@@@@@@@@@@@@@..@@@@@@@@@@@@@@@..@@@@@@@@@@@@@@@...
.......................................................
.......................................................
...@@@@@@@@@@@@@@@..@@@@@@@@@@@@@@@..@@@@@@@@@@@@@@@...
...@@@@@@@@@@@@@@@..@@@@@@@@@@@@@@@..@@@@@@@@@@@@@@@...
.......................................................
.......................................................
